$$$ exec p1 : [PLAYER_NAME]
Plateau 14 30:
    012345678901234567890123456789
000 ..............................
001 ..............................
002 ..X...........................
003 ..............................
004 ..............................
005 ..............................
006 ..............................
007 ..............................
008 ..............................
009 ..............................
010 ..............................
011 ...........................O..
012 ..............................
013 ..............................
Piece 4 7:
...*...
...*...
...*...
..***..
Plateau 14 30:
    012345678901234567890123456789
000 ..............................
001 ..............................
002 ..xx..........................
003 ..............................
004 ..............................
005 ..............................
006 ..............................
007 ..............................
008 ..............................
009 ..............................
010 ..............................
011 ...........................O..
012 ..............................
013 ..............................
Piece 4 8:
.......
...*...
..**...
..*....
